SalePrice: цена продажи объекта в долларах. Это целевая переменная, которую вы пытаетесь предсказать.

MSSubClass: класс здания 
MSZoning: Общая классификация зонирования 

LotFrontage: фунты улицы, соединенной с участком
LotArea: Размер лота в квадратных футах

Street: Тип подъездной дороги
Alley: Тип подъезда к аллее
LotShape: Общая форма собственности
LandContour: Плоскостность собственности
Utilities: Тип имеющихся утилит
LotConfig: Конфигурация лота
LandSlope: склон собственности
Neighborhood: Физические места в черте города Эймс

Condition1: Близость к главной дороге или железной дороге
Condition2: Близость к главной дороге или железной дороге (если есть вторая)

BldgType: Тип жилья
HouseStyle: Стиль жилища

OverallQual: Общий материал и качество отделки
OverallCond: Общая оценка состояния

YearBuilt: Дата постройки
YearRemodAdd: Дата реконструкции

RoofStyle: Тип крыши
RoofMatl: Материал крыши

Exterior1st: Наружное покрытие дома
Exterior2nd: Наружное покрытие дома (если используется более одного материала)

MasVnrType: Тип облицовки кладки
MasVnrArea: Площадь облицовки кладки в квадратных футах

ExterQual: Качество наружных материалов
ExterCond: Текущее состояние материала снаружи
Foundation: Тип фундамента

BsmtQual: Высота подвала
BsmtCond: Общее состояние подвала
BsmtExposure:  Подвальные стены на уровне сада или выхода
BsmtFinType1: Качество готовой площади подвала
BsmtFinSF1: Готовые квадратные футы типа 1
BsmtFinType2: Качество второй законченной области (если есть)
BsmtFinSF2: Готовые квадратные ножки типа 2
BsmtUnfSF: Незавершенные квадратные футы подвала

TotalBsmtSF: Общая площадь подвала в квадратных футах

Heating: Тип отопления
HeatingQC: Качество и состояние отопления
CentralAir: Центральное кондиционирование
Electrical: электрическая система

1stFlrSF: квадратные футы на первом этаже
2ndFlrSF: Площадь второго этажа в квадратных футах

LowQualFinSF: квадратные футы с отделкой низкого качества (все этажи)
GrLivArea: квадратные футы жилой площади над уровнем земли

BsmtFullBath: Полные ванные комнаты в подвале
BsmtHalfBath: полуподвальные ванные комнаты
FullBath: Полные ванные комнаты выше уровня
HalfBath: Полуванны выше уровня

Bedroom: Количество спален над цокольным этажом

Kitchen: Количество кухонь
KitchenQual: Качество кухни

TotRmsAbvGrd: Общее количество комнат выше уровня (без ванных комнат)
Functional: Рейтинг функциональности дома

Fireplaces: Количество каминов
FireplaceQu: качество камина

GarageType: расположение гаража
GarageYrBlt: Год постройки гаража
GarageFinish: Внутренняя отделка гаража.
GarageCars: Размер гаража по вместимости машины
GarageArea: Размер гаража в квадратных футах.
GarageQual: качество гаража
GarageCond: Состояние гаража

PavedDrive: подъездная дорога с твердым покрытием

WoodDeckSF: Площадь деревянного настила в квадратных футах
OpenPorchSF: Площадь открытой веранды в квадратных футах

EnclosedPorch: Площадь крыльца в квадратных футах.
3SsnPorch: Площадь крыльца на три сезона в квадратных футах
ScreenPorch: Площадь крыльца экрана в квадратных футах

PoolArea: Площадь бассейна в квадратных футах.
PoolQC: качество бассейна

Fence: качество забора

MiscFeature: прочие функции, не включенные в другие категории
MiscVal: $ Значение разной функции

MoSold: месяц продажи
YrSold: Год продажи

SaleType: Тип продажи
SaleCondition: Состояние продажи 